111111111111111111
100000000000000001
100000000000000001
1E000000000P111111
100000000000100011
110000C00000000P01
111111111111111111