111111111111111111
1000C000000C000001
100000000E00000001
1E000000000P111111
1000000C0000100011
110000C0000E000001
111111111111111111